1 13 31
###############################
#   s  ** *  1 *   *  * * *   #
# # #b#*# # #*#*# # # #*#*#*# #
#32 x*    ***  *  1   *   * * #
# # # # # #*# # #*#*# # # # #*#
#f   h 5   x **  *  *   6  8  #
# # # # # # # # # #*# #*# # # #
#*  *      *  *   7  *   9    #
# #p# # #*# # # #*#*# # # # # #
#*    **  *       *     6     #
# #*# # # # # # #*# # # # # # #
#           *   *  *    5 24  #
###############################

//
s : speed up
b : more bomb
h : more lives
p : flame up