1 13 31
###############################
#   s  ** *  1 *   *  * h *   #
# # #b#*# # #*#*# # # #*#*#*# #
#32 x*    *s*  *  1   *  9* * #
# # # # # #*# # #*#p# # # # #*#
#f   h 5   x **  *  *    6    #
# # # # # # # # # #*# #*# # # #
#*  *      *  *   7  *   8    #
# # # #     # # #*#b# # # # # #
#*    *h  *    7        6     #
# #*# # # # # # #*# # # # # # #
#           s   *  *    1 24  #
###############################

//
s : speed up
b : more bomb
h : more lives
p : flame up