1 13 31
###############################
#p  s  ** *  1 *   *  * * *   #
# # #b#*# # #*#*# # # #*#*#*# #
#32 x*    ***  *  1   *   * * #
# # # # # #*# # #*#*# # # # #*#
#f   h 5   x **  *  *         #
# # # # # # # # # #*# #*# # # #
#*  *      *  *   7  *        #
# # # # #*# # # #*#*# # # # # #
#*    **  *       *     6     #
# #*# # # # # # #*# # # # # # #
#           *   *  *    1 24  #
###############################


