1 13 31
###############################
#p     ** *  1 *   *  * * *   #
# # # #*# # #*#*# # # #*#*#*# #
#32 x*    ***  *  1   *   * * #
# # # # # #*# # #*#*# # # # #*#
#f     5   x **  *  *   1     #
# # # # # # # # # #*# #*# # # #
#*  *      *  *      *        #
# # # # #*# # # #*#*# # # # # #
#*    **  *       *     6     #
# #*# # # # # # #*# # # # # # #
#           *   *  *      24  #
###############################


